cabeza - cabeça
ojo - olho
boca - boca
mano - mão
brazo - braço
pierna - perna
pie - pé
espalda - costas
corazón - coração
piel - pele
niño - menino
niña - menina
niños - crianças
hombre - homem
mujer - mulher
comida - comida
comer - comer
comilón - comilão
joven - jovem
abuelo - avô
abuela - avó
padre - pai
madre - mãe
joven - jovem
hijo - filho
hija - filha
padrastro - padrasto
madrastra - madrasta
casa - casa
hogar - lar
